###### PROVIDER-PASSWORDS ######
tnttnkdyuo -- customercare@elpedison.gr
jqgxogfahm -- info@eunice-group.com
evmygtntmt -- cs@nrg.gr
dkqmfxhnca -- info@ote-estate.gr
dlsogutogf -- info@prot-energy.gr
vnahyunhkr -- supply@soumpasis.gr
jczimmxocy -- customercare@volterra.gr
zecuizdnoy -- info@volton.gr
ohxwsnkgcw -- info@dei.com.gr
dopgluhsvp -- info@elin.gr
copqxbkoxn -- info@zenith.gr
xgnadouycc -- customercare@heron.gr
xshywyqbhj -- customerservice@fysikoaerioellados.gr
###### EMPLOYEE-PASSWORDS ######
quzsckcvjf -- williamsrebecca@hotmail.com
wluqqmxori -- amyrodriguez@yahoo.com
aiiwpxdfon -- vblake@gmail.com
syhlkfyptw -- reyesmichael@gmail.com
gxsbkmzgvy -- amywashington@gmail.com
###### CONSUMER-PASSWORDS ######
byybqqlser -- titos.mpalasi@hol.gr
gzkclgjfio -- vladimiros.pantou@gmail.com
grnfvdwzoo -- eukleidis02@gmail.com
dqlwwawuvp -- mandros.kosmas@googlemail.gr
swtsvidcgj -- odysseia.mpika@googlemail.gr
ykfsjagwal -- dpapaeuaggeliou@otenet.gr
tlbnabwvct -- mpakostergiou.aias@otenet.gr
fhxlgizhjk -- pzacharioudaki@hol.gr
wlemjowmqj -- kimon33@gmail.com
zirovmxerr -- vkaramani@otenet.gr
huostuhtmh -- lygeri23@forthnet.gr
gxcjfoxygn -- giannopoulou.komninos@forthnet.gr
eoivymmilz -- christiana.gkaliou@googlemail.gr
knpgdcvxxd -- rfotopoulos@hotmail.gr
jayzcmjqfp -- christou.makarios@otenet.gr
ykmasukwun -- anagnostis07@hotmail.gr
hdgfcqetje -- alexios49@hol.gr
cnpewgdtlu -- eirini06@gmail.com
oywnsslscr -- eufrosyni.koulocheri@gmail.com
eezlnmkiox -- dikaios26@googlemail.gr
zbbfbpxbra -- sotirios.garoufalis@googlemail.gr
tkxfidztpq -- bdoulgeraki@otenet.gr
ecwclmfjbl -- tenotiadi@forthnet.gr
pguwzzwxnt -- nikoleta.mparkouta@googlemail.gr
witwvunknb -- tkoutsikos@gmail.com
smwoisobpi -- mauraeidi.ino@googlemail.gr
sputgufnnm -- pausanias75@forthnet.gr
fvrlwhiddx -- tvamvoukaki@googlemail.gr
rrukaaubcs -- anastasia.panousis@hotmail.gr
czpakclfhl -- gkikas53@gmail.com
dauazquwmi -- antigoni.christodoulakis@yahoo.gr
nmbursqnjy -- amvrosios.eukarpidis@yahoo.gr
ltfccyjqzv -- symeon.sarafidis@forthnet.gr
wwqkgyeyzk -- rea43@hotmail.gr
rclctqkjxe -- aetopoulos.theofania@otenet.gr
ypfamzcuoi -- artemisia95@forthnet.gr
ohyrqvqapt -- iakovos66@hotmail.gr
gqoypxvvfi -- fereniki.papoutsopoulou@googlemail.gr
ujelqouqkh -- kontogeorgaki.danai@gmail.com
vofdimqmen -- vfilka@forthnet.gr
jwzwjwnpri -- chrysanthos.feizatidou@googlemail.gr
dduakkumfv -- foteinos.smyrniotis@hol.gr
pvskzcxgaw -- spanoudakis.agapi@otenet.gr
ygnoavdpkg -- michalis49@hotmail.gr
bdjbsyfzdi -- afroditi38@hotmail.gr
utrptgicvd -- szidianakis@hol.gr
hnulkvdkte -- triftanidou.eumorfia@yahoo.gr
idqxzjvgao -- grigorios20@forthnet.gr
hjdnijvyda -- adigkas@otenet.gr
yvpdskfjmt -- veroniki.stamelou@otenet.gr
rmntrxjrkp -- vtosouni@otenet.gr
kbqjqedvpm -- ion83@hotmail.gr
pwvrwtpjgs -- auxentios45@otenet.gr
dudpwbxkkc -- kosmas.dovas@hotmail.gr
lswdzgbiec -- ogiannara@googlemail.gr
lrapkhutwa -- tziotzis.serafeim@googlemail.gr
xxqcdxaauf -- loulakis.meropi@gmail.com
ybakbhwgpg -- htachas@forthnet.gr
ykedkhuwsv -- karantana.minoas@googlemail.gr
uznjyhfhud -- theocharis02@forthnet.gr
lrxdhubcsv -- fmysirlis@yahoo.gr
olenjuaneu -- chionia.mpotza@gmail.com
ajvdhaecaa -- kostoulas.pagona@googlemail.gr
parfnvbryu -- syrgis.paschalis@yahoo.gr
bisendjpjy -- drosos74@yahoo.gr
szikgpipbs -- petra23@hol.gr
oorqarlpta -- varaklis.antonia@googlemail.gr
degjiawgrn -- geropoulos.tzeni@gmail.com
dyoyhedzjg -- aristotelis.patsourea@forthnet.gr
jwgnayvbzr -- toromidis.ivi@hol.gr
pajgzgnoye -- kleopas24@googlemail.gr
zetpjftraw -- christiana05@otenet.gr
twlrlgtbdr -- marchaulis@forthnet.gr
carrrskqeu -- tatiana.vasilakis@hol.gr
igbtgacncs -- utsouknidas@googlemail.gr
shpjaemdhh -- praxitelis27@googlemail.gr
apwmjobaxb -- manoukas.agapios@yahoo.gr
xnchzuosuu -- ariadni.karkaletsi@googlemail.gr
jsvsrcwzql -- christiana66@gmail.com
wffczshary -- stergianno97@otenet.gr
yeztkcweay -- thaleia81@gmail.com
czgqwswcgf -- xpantazis@gmail.com
gthmdyoier -- thalis39@hol.gr
sevtaseqnb -- antypas64@googlemail.gr
ahfccbgohj -- aggelidis.prodromos@hotmail.gr
dorowvdeah -- pindaros49@googlemail.gr
kcfwiznzfb -- meropi.archaulis@gmail.com
sgkvtwizji -- manto.tsiantas@hol.gr
yzkvlimczh -- floriant.petridou@hol.gr
nbypwsqjgj -- sofoklis.chatzicharistou@googlemail.gr
wtzeftxnbe -- giasimakis.zafeiris@gmail.com
zmezxgnsgc -- wmatsoukas@hotmail.gr
raymlrggpx -- sotiria36@hol.gr
fbrbfoqqzm -- ananias.iakovakis@hotmail.gr
ynepghubwy -- kypriani.rokka@yahoo.gr
zhwsxlluxj -- archontia.tsounakou@yahoo.gr
mbrbgueskm -- sakellariou.agathoklis@yahoo.gr
vzouikzvng -- loukianos28@hol.gr
kqvdtniorm -- eustratia.theodosiou@googlemail.gr
wxqjtswraa -- filimon.anastasakis@otenet.gr
