###### EMPLOYEE-PASSWORDS ######
uwrehfljiq -- stephanie06@hotmail.com
nltsdxkpnu -- fford@hotmail.com
mzrczdcgxr -- julie61@yahoo.com
jcqabwqrgj -- guyfoster@hotmail.com
pmitxwuwnv -- tonyschwartz@gmail.com
###### CONSUMER-PASSWORDS ######
jtzfzatzwt -- gdardioti@gmail.com
trlnmangqu -- kotrotsou.amvrosios@hol.gr
yledxrimqb -- frantzeska38@otenet.gr
amlkqjolev -- anatoli.matsoukas@gmail.com
uwfpqiyvan -- pmanelidis@forthnet.gr
anxrwjhhsk -- mgkoutzamanis@hol.gr
ahntffcbgz -- katakis.afentis@otenet.gr
eivneimqme -- zinais36@hol.gr
qliuuqjtda -- zampia.papandrikopoulou@yahoo.gr
hmaesjmtuf -- dimokritos61@yahoo.gr
vgymuwmbam -- papandreou.ourania@forthnet.gr
hzubrsifjy -- porichis.theoklitos@googlemail.gr
oyvmyewovw -- aliki77@forthnet.gr
hkowcxpfoy -- agapi61@gmail.com
qkvaeprmhz -- tsanaka.komnini@yahoo.gr
dzisdqjipj -- otsounakou@gmail.com
proghcbxne -- doulamis.meletios@googlemail.gr
xitqmrnmnl -- llyri@hol.gr
eyotllrgzf -- miliadou.stamatis@forthnet.gr
mvwztvvvyz -- aretha43@yahoo.gr
kqbdftvfai -- neokleia91@hotmail.gr
zzjiwxgnky -- georgakopoulou.taxiarchis@yahoo.gr
mfqdvtvofb -- makrykostas.theokleia@googlemail.gr
macalnximf -- moschovaki.konstantia@forthnet.gr
mkgnaamhqg -- papadopoulou.lygeri@googlemail.gr
bmrkavtqiu -- kyriazis.kelaidonis@gmail.com
pucftfgbuc -- aristovoulos.xenaki@hol.gr
aptgcmbdcw -- dmargaritaki@gmail.com
rcjukiegbg -- minerva26@gmail.com
ckcqjhlkkx -- pelopidas09@hotmail.gr
cwhixikjoc -- ssarros@googlemail.gr
plxnbrhbkx -- chari68@googlemail.gr
jxeejmvlbx -- tstefanou@yahoo.gr
kzvmgtynjb -- leon.koutsikos@yahoo.gr
fspunibspy -- ifigeneia83@otenet.gr
xfqkfcuicj -- lporichis@googlemail.gr
gzejcyibcf -- kgeorgakopoulou@forthnet.gr
sdwrhoszjg -- ioanna82@forthnet.gr
llfhotyaqi -- polydoros33@forthnet.gr
vyxzekbmcy -- artemis.perdikis@forthnet.gr
sotosihvba -- aristotelis.tsemperlidis@forthnet.gr
agahpyhhjl -- paris.tompoulidou@forthnet.gr
fgtllpqlqw -- pantziou.veniamin@otenet.gr
ijsdfcqzom -- rtzigkoura@hol.gr
zecnouxmcz -- eustathia.kypriotis@googlemail.gr
wvtsvujgqc -- tkouthouri@hotmail.gr
ujlftuvdpt -- wtsomokos@googlemail.gr
uamkklofbv -- ilektra15@hotmail.gr
jguxzepnig -- othon.ntova@gmail.com
ekbwjlyvwm -- argyrios.tsagliotis@googlemail.gr
yfzqkphrqd -- ragkousis.daniil@hol.gr
nspzmxhaxh -- chloi.kyriazis@hotmail.gr
njmjpbydwu -- thoukydidis93@yahoo.gr
vpvxmbbfus -- athanasia.koulizos@gmail.com
gllmqnqxlf -- margia.ektoras@gmail.com
dfdokcwjog -- christodoulos.terzis@googlemail.gr
vtixqojbrf -- pantazis.euaggelatos@hol.gr
onyppvdbaf -- kalliroi.stamatiadis@gmail.com
nhnnadamwu -- megaklis.gerouki@forthnet.gr
acpqzfxhpm -- giorgos49@hotmail.gr
ghaisdtxuk -- qchantzi@hotmail.gr
gkhnihpqhq -- pantazis46@otenet.gr
lbdtlmtmtz -- wkatakis@hol.gr
ijxboghtwc -- doukissa72@gmail.com
zoibcdneug -- pothiti24@gmail.com
wvhzqhmfaw -- euthymia.papagiannis@hol.gr
xijbvtctac -- komkoudis.promitheas@hol.gr
zfbeqrlbhz -- dorothea.miliadou@hol.gr
omtoonkwfw -- pinelopi60@googlemail.gr
vicxxzkbes -- alexandridou.sarra@hotmail.gr
jeesiqxyhc -- niki09@googlemail.gr
gbqcqgputu -- theoni52@hol.gr
yvbvoebrnh -- eustratia.athanasopoulos@hotmail.gr
yorkzwwglb -- gerakina61@googlemail.gr
ahfmfpxoll -- kalliniki88@googlemail.gr
hggvkqrrcw -- orfeas52@hol.gr
skphnyupnd -- stamoulis.asimina@googlemail.gr
nryqgfkgpk -- stefania.aslanidou@forthnet.gr
poizalghge -- zampeta.moraiti@googlemail.gr
ujpdnhvxvy -- kimon00@gmail.com
xcqnypjmir -- ippokratis90@hotmail.gr
nkwjvubvgv -- fani14@gmail.com
pxgybgcipq -- polyzois.pankidou@forthnet.gr
mfnvzbdqrx -- symeon.mandros@yahoo.gr
kdqhgzyhua -- reggina.pallas@yahoo.gr
oxvipviiik -- ioanna35@otenet.gr
tljxjcljqw -- zormpas.erotokritos@yahoo.gr
vvcqslqwrm -- agapios93@forthnet.gr
gxnodjljfw -- maurikios66@forthnet.gr
qktonlzgqk -- iason.falieros@hotmail.gr
emulxcbwik -- pkravvaritis@hotmail.gr
fdvlpahxww -- ymanousopoulou@gmail.com
benfsmwkjc -- dimos.mpotziori@forthnet.gr
tkpxmhjyyy -- titos60@hotmail.gr
pgtqopguof -- antipatros65@otenet.gr
pwfkulznzl -- cpatsouras@hotmail.gr
odkanotehd -- mauros50@googlemail.gr
srbdyetvmi -- nikolaos.chontzia@gmail.com
ixtnajvxsn -- eumenios.miliaki@googlemail.gr
zfvjtywzim -- eumorfia.galani@forthnet.gr
###### PROVIDER-PASSWORDS ######
uotvexelgf -- customercare@elpedison.gr
uprnhanvlz -- info@eunice-group.com
sonbuuzdky -- cs@nrg.gr
ddayfutvqf -- info@ote-estate.gr
cxovnylgxf -- info@prot-energy.gr
lhuirgmoft -- supply@soumpasis.gr
vjgdnbpmqj -- customercare@volterra.gr
xwvoygnbao -- info@volton.gr
krvfakewmf -- info@dei.com.gr
fuikmsnwoo -- info@elin.gr
pdcsakugox -- info@zenith.gr
wyoyxgkkcv -- customercare@heron.gr
uqrqiflzlg -- customerservice@fysikoaerioellados.gr
